11111111111111111111111111111111111111111
10000000000000000000000000000010000000001
10000000000000000000000000000010000000001
10000000000000000000000000000010000000001
10000000000000000000000000000010000000001
10000000000000000000000000000010000000001
10000000000000000000000000000010000000001
10000000000000000000000000000010000000001
10000000000000000000000000000010000000001
10000000000000000000000000000010000000001
10000000000000000000000000000010000000001
10000000000000000000000000000010000000001
10000000000000000000000000000010000000001
10000000000000000000000000000010000000001
10000000000000000000000000000000000000001
10000000000000000000000000000000000000001
10000000000000000000000000000000000111111
10000000000000000000000000000010000000001
10000000000000000000000000000010000000001
10000000000000000000000000000010000100001
100000000000000000000000000000100001000N1
11111111111111111111111111111111111111111
