NO ./walls/eagle.xpm
SO ./walls/bluestone.xpm
WE ./walls/redbrick.xpm
EA ./walls/shinybrick.xpm
DO ./walls/doorskin.xpm
FL ./walls/colorstone.xpm
CL ./walls/Elements.xpm
F 220,100,0
C 225,30,0

11111111111111111111111111111111111111111
10000000100000001000000000000010000000001
1000E000X000000010000000000000X0000000001
1000000010000000111X111000000010000000001
11111X11111100001000001000000010000000001
1000000000010000100000111111X111111X11111
1000000000010000100000X000000010000000001
1000000000010000X000001000000010000000001
11111X111111000010000011X1111110000000001
1000000000011X11111X111000000010000000001
10000000000100000000001000100010000000001
10000000000100000000001000100011111X11111
11111X11111111111X11111111100010000000001
1000000000000000000000000011X110000000001
100000000000000000000000000000X0000000001
10000000000000000000000000000010000000001
10000000000000000000000000000011X11111111
111X11111111111X1111X1111111X110000100001
10000010000X00000010001000100010000X00001
10000010000100000010001000100010000100001
100000X00001000000X000X000X00010000100001
11111111111111111111111111111111111111111
