NO ./walls/eagle.xpm
SO ./walls/bluestone.xpm
WE ./walls/redbrick.xpm
EA ./walls/shinybrick.xpm
DO ./walls/door101.xpm
FL ./walls/Fires.xpm
CL ./walls/eagle.xpm

            1111111111111111111111111111111
            1000000000000000000000000000001
            10000000000000000000000000000011111111111
            10000000000000000000000000000000000000001
            10000000000000000000000000000000000000001
            10000000000000000000000000000000000000001
            10000000000000000000000000000000000000001
            10000000000000000000000000000000000000001
11111111111110000000000000000000000000001111111111111
10000000000000000000000000000000000000001
10000000000000000000000000000000000000001
10000000000000000000000000000000000000001
10000000000000000000000000000000000000001
10000000000000000000000000000000000000001
10000000000000000000000000000000000000001
10000000000000000000000000000000000000001
10000000000000000000000000000000000000001
10000000000000000000000000000000000000001
10000000000000000000000000000000000000001
10000000000000000000000000000000000000001
10N00000000000000000000000000000000000001
11111111111111111111111111111111111111111
