NO ./walls/eagle.xpm
SO ./walls/bluestone.xpm
WE ./walls/redbrick.xpm
EA ./walls/shinybrick.xpm
DO ./walls/door101.xpm
FL ./walls/Fires.xpm
CL ./walls/eagle.xpm

1111111111111111111111111111111111111111111111111111111
