NO ./walls/eagle.xpm
SO ./walls/bluestone.xpm
WE ./walls/redbrick.xpm
EA ./walls/shinybrick.xpm
DO ./walls/doorskin.xpm
FL ./walls/colorstone.xpm
CL ./walls/Elements.xpm

11111111111111111111111111111111111
10000000000000000000000100000000001
10000000000000000000000100000000001
10000000000000000000000100000000001
10000022222000030303000100000000001
10000020002000000000000100000000001
10000020002000030003000100000000001
10000020002000000000000111111111111
100000220220000303030001
100000000000000000000001
100000000000000000000001
10000000000000000000000111
10000000000000000000000101
10000000000000001000000011
1000000000000000000000011
1000000000000000E0000001
11444444400000000000000111111111111
14040000400000000000000100000000001
14000050400000000000000100000000001
14040000400000000000000100000000001
14044444400000000000000100000000001
14000000000000000000000100000000001
14444444400000000000000100000000001
11111111111111111111111111111111111
