NO	 		 ./walls/eagle.xpm
SO ./walls/bluestone.xpm
WE ./walls/redbrick.xpm
EA ./walls/shinybrick.xpm
DO ./walls/door101.xpm
FL ./walls/Fires.xpm
CL ./walls/eagle.xpm

1111111111111111111111111111111111111111111111111111111
1000000000100000000000100000001000000102222222222222221
1000000000100000000000100000001000000102222222222222221
10000S0000X02000000020X02000001000000102222222222222221
1000000000100000200000100000001000000102222222222222221
1000000000100000000000100000001000000102222222222222221
11111X1111111111X1111110000000X000000X02222222222222221
1000000000001000000000100000001000000102222222222222221
1222222222221000200020X00000001000000102222222222222221
1222222222221000000000100000001000200102222222222222221
122222222222X020000000100000001000000100000000000000001
111111X111111111111111111111111111X11111111111111111111
1000000000001000000000000000000000000001000000000000001
1000000000001022222222222222222222222221000000000000001
100000000000X022222222222222222222222221000000000000001
100000000000102222222222222222222222222X020000000000001
1000022220001022222222222222222222222221000000000000001
1000020020001022222222222222222222222221000000000000001
111111X11111111111111111X111111111111111111111X11111111
1000000000000000000000000000000000000001000000000000001
1222222222222222222222222222222222222201222222222222221
1222222222222222222222222222222222222201222222222222221
1222222222222222222222222222222222222201222222222222221
1222222222222222222222222222222222222201222222222222221
1222222222222222222222222222222222222201111111X11111111
1222222222222222222222222222222222222200000000000000001
1222222222222222222222222222222222222222222222222222221
1222222222222222222222222222222222222222222222222222221
1222222222222222222222222222222222222222222222222222221
1222222222222222222222222222222222222222222222222222221
1222222222222222222222222222222222222222222222222222221
1222222222222222222222222222222222222222222222222222221
1222222222222222222222222222222222222222222222222222221
1222222222222222222222222222222222222222222222222222221
1222222222222222222222222222222222222222222222222222221
1111111111111111111111111111111111111111111111111111111
